XXXXXXXXXXXXXXXX
XS0000000000000X
X0000000000XX00X
X00XXX00000XX00X
X00XXX000000000X
X00XXX000000000X
X00XXX000XXX000X
X00XXX000XXX000X
X00000000XXX000X
X00000000XXX000X
X00000000XXX000X
X0000X000000000X
X000XXX00000000X
X00XXXXX0000000X
X0000000000000GX
XXXXXXXXXXXXXXXX